10.ox
................o.o.
.oo.............o.o.
o....o..........o.o.
......oo......oooooo
.o..o.oo........o.o.
..oo..oo.oo..o......
o..o......o..o......
o.....ooo.o.....ooo.
oo....oo..oo....oo..
.o.......oo.....ooo.
........o.o.....ooo.
.oo......ooo....oo..
o....o....o.....ooo.
......ooo.oo....oo..
.o..o.oo...o..o.oo..
..oo..oo.ooo....oo..
o..o......oo....oo..
o.....ooo.o.....aaa.
oo....oo..oo....oo..
.o.......oo.....ooo.
