50.ox
...........o...o.......o....o.....o...o......o.o..
..o.o.......o.o...........o..o....o...............
..o..........o...o...oo..o...o....o.......o..o....
....o.oo.....oo.........oo.o....o........o...o.oo.
.o..o.........o.o...o..............o.o..oo....o.o.
.....o.oooo.o.....o.o...o.o.o........o.o..o..o....
o.o.oo....ooo...............o.....o...............
....o.o..oo....................o.........oo.......
...........o.o.........o........o.o...o..o..oo....
....o.o.....o...o..o..o...o.o..o..o.....o.o....o..
.oo..o.....o...o.o..................oo.......o....
.o....o..o.ooo...oo...o...o.................o....o
....o..oo.....o.o.o...o.....o......o...oo.........
.o..o........o...........o..o.ooo............oo...
o...o.o...o...o...o...o.o.......o...ooo...........
.....o..o........o...o..o..o...............o......
o..o...oo......oo...o....o.........o.....o.....o.o
..oo..o.o........o......o...........oo.......o..o.
........oo..o.......oo.............o.............o
.o.o...o......o.o.oo.o.....o.....o.o.o...o........
.......o.o..........o.....o..........o..o.....o...
.......o.o.....o...o......o....oo.....o...o.......
..o........o.............o.....o.o....o........oo.
.........o.o....oo.................o.....o........
oo.o...........o.......o..o......o.....oo.o.......
........oo.........o....o................oo.....o.
..oo.o........o.o.o....o........o..o....o.......o.
o...o.oo.o........o...o..o..o.o.o..........oo...o.
..........o..o.o........o..o......o..oo.o.........
....oo..oo..o..o....o.ooo..oo...oo...o...oo.....oo
..........o......ooo....o..oo...........o.o.......
o...o.o.........o......o................oo..o..o..
..o..................................o.......oo...
..........o...oo....oo...........o......o......o..
..................o.o.o.o..ooo...o..oo..o.o..oo...
......o.........o........o.......oo...............
..o.o..o...o.o....oo..o..............o............
..........o.o.......o...oo.....o..........ooo.....
.......o.o...o.o..........oo............oo.......o
.o......o..o...o.o.o.....o..o...o.....o.o.o.o.....
.o.........o.......................o........o.....
o..o.oo...o.........o.o.............o.....oo...oo.
..o.o....o.....o.o.....o.o....o.....o.o.....o.....
........o.........oo....o.....................o...
.o......o.....o.o...o..o..o.........oo.....o......
o.....o...oo......o......o....o..o.oo.............
.o......o....o...............oo...o.......o.......
.....o.....o......................................
...o......................o.oo........o...o.......
o.o..o.....oo.........o............oo..o........o.
