10.ox
........o.
.oo......o
o....o....
......ooo.
.o..o.oo..
..oo..oo.o
o..o......
o.....ooo.
oo....oo..
.........o